8,0,0,0,0,0,0,0,0,0,0,0,0,0,0,0,0,0,0,0,0,0,0,0,0,0,0,0,0,0,0,0,0,0,0,0,9
11,-1,-1,-1,-1,-1,-1,-1,-1,-1,-1,-1,-1,-1,-1,11,-1,-1,-1,-1,-1,-1,-1,-1,-1,-1,-1,-1,-1,-1,-1,-1,-1,11,-1,-1,11
11,-1,-1,-1,-1,-1,-1,-1,-1,-1,-1,-1,-1,-1,-1,11,-1,-1,-1,-1,-1,-1,-1,-1,-1,-1,-1,-1,-1,-1,-1,-1,-1,11,-1,-1,11
11,-1,-1,-1,-1,-1,-1,-1,-1,-1,-1,-1,-1,-1,-1,11,-1,-1,11,-1,-1,8,10,10,10,10,10,10,10,10,9,-1,-1,11,-1,-1,11
11,-1,-1,-1,8,10,10,10,10,10,10,10,10,-1,-1,11,-1,-1,11,-1,-1,11,-1,-1,-1,-1,-1,-1,-1,-1,11,-1,-1,11,-1,-1,11
11,-1,-1,-1,11,-1,-1,-1,-1,-1,-1,-1,-1,-1,-1,11,-1,-1,11,-1,-1,11,-1,-1,-1,-1,-1,-1,-1,-1,11,-1,-1,11,-1,-1,11
11,-1,-1,-1,11,-1,-1,-1,-1,-1,-1,-1,-1,-1,-1,11,-1,-1,11,-1,-1,6,10,10,10,10,10,9,-1,-1,11,-1,-1,11,-1,-1,11
11,-1,-1,-1,11,-1,-1,-1,11,-1,-1,-1,-1,-1,-1,11,-1,-1,11,-1,-1,-1,-1,-1,-1,-1,-1,11,-1,-1,11,-1,-1,11,-1,-1,11
11,-1,-1,-1,11,-1,-1,-1,11,-1,-1,-1,-1,-1,-1,11,-1,-1,11,-1,-1,-1,-1,-1,-1,-1,-1,11,-1,-1,11,-1,-1,11,-1,-1,11
11,-1,-1,-1,11,-1,-1,-1,11,-1,-1,-1,-1,-1,-1,11,-1,-1,11,-1,-1,-1,-1,-1,-1,-1,-1,11,-1,-1,11,-1,-1,11,-1,-1,11
11,-1,-1,-1,11,-1,-1,-1,11,-1,-1,-1,-1,-1,-1,11,-1,-1,11,-1,-1,8,10,10,10,10,10,7,-1,-1,11,-1,-1,11,-1,-1,11
11,-1,-1,-1,11,-1,-1,-1,11,-1,-1,-1,-1,-1,-1,11,-1,-1,11,-1,-1,11,-1,-1,-1,-1,-1,-1,-1,-1,-1,-1,-1,-1,-1,-1,11
11,-1,-1,-1,11,-1,-1,-1,11,-1,-1,-1,-1,-1,-1,11,-1,-1,11,-1,-1,11,-1,-1,-1,-1,-1,-1,-1,-1,-1,-1,-1,-1,-1,-1,11
11,-1,-1,-1,11,-1,-1,-1,11,-1,-1,-1,-1,-1,-1,11,-1,-1,11,-1,-1,11,-1,-1,10,10,10,10,10,10,10,10,10,10,10,10,11
11,-1,-1,-1,11,-1,-1,-1,11,-1,-1,-1,-1,-1,-1,11,-1,-1,11,-1,-1,11,-1,-1,-1,-1,-1,-1,-1,-1,-1,-1,-1,-1,-1,-1,11
11,-1,-1,-1,11,-1,-1,-1,11,-1,-1,-1,-1,-1,-1,11,-1,-1,11,-1,-1,11,-1,-1,-1,-1,-1,-1,-1,-1,-1,-1,-1,-1,-1,-1,11
11,-1,-1,-1,11,-1,-1,-1,11,-1,-1,-1,-1,-1,-1,11,-1,-1,11,-1,-1,11,-1,-1,10,10,10,10,10,10,10,10,10,9,-1,-1,11
11,-1,-1,-1,11,-1,-1,-1,6,10,10,10,10,10,10,6,10,10,7,-1,-1,11,-1,-1,-1,-1,-1,-1,-1,-1,-1,-1,-1,11,-1,-1,11
11,-1,-1,-1,11,-1,-1,-1,-1,-1,-1,-1,-1,-1,-1,-1,-1,-1,-1,-1,-1,11,-1,-1,-1,-1,-1,-1,-1,-1,-1,-1,-1,11,-1,-1,11
11,-1,-1,-1,11,-1,-1,-1,-1,-1,-1,-1,-1,-1,-1,-1,-1,-1,-1,-1,-1,11,-1,-1,-1,-1,-1,-1,-1,-1,-1,-1,-1,11,-1,-1,11
11,-1,-1,-1,11,-1,-1,-1,-1,-1,-1,-1,-1,-1,-1,-1,-1,-1,-1,-1,-1,11,-1,-1,-1,-1,-1,-1,-1,-1,-1,-1,-1,11,-1,-1,11
11,-1,-1,8,10,10,10,10,10,10,10,10,10,10,10,10,10,10,10,10,10,10,10,10,10,10,10,10,10,10,10,10,10,7,-1,-1,11
11,-1,-1,11,-1,-1,-1,-1,-1,-1,-1,-1,-1,-1,-1,-1,-1,-1,-1,-1,-1,-1,-1,-1,-1,-1,-1,-1,-1,-1,-1,-1,-1,-1,-1,-1,11
11,12,-1,11,-1,-1,-1,-1,-1,-1,-1,-1,-1,-1,-1,-1,-1,-1,-1,-1,-1,-1,-1,-1,-1,-1,-1,-1,-1,-1,-1,-1,-1,-1,-1,-1,11
6,0,0,0,0,0,0,0,0,0,0,0,0,0,0,0,0,0,0,0,0,0,0,0,0,0,0,0,0,0,0,0,0,0,0,0,7
